26 22
##########################
#.o..o..oom.#    ########
#..omo.o.o..######......#
#.oo....o...............#
#mo..k......######......#
#o..........#    #......#
#...........#    #......#
#...........#    #......#
#####r.######    ###dd###
    #r.#
    #r.#
    #.r#
  ###.r####
  #WWr..a.#
  #t..r...#
  #...@...#
  #G....tt#
  #.GG..c.#
  #G...Wtw#
  #########
  #
  #